################################
###    O###                    #
#      ### #####################
#   #                    X  #  #
#   X     X       ####  O#  #  #
##### ################      #  #
#   # ###         ###O   ###   #
#  #OO#############      #######
# #                X         P##
# #  O#########           ######
#  ##          X     #####     #
#   #    ######X    #          #
#   #    #    #     #          #
################################
