##################################
#             ###                #
#             #                  #
#                    O           #
#                       O        #
#              X                 #
#               #                #
#X            ###                #
##################################
