##################################
#             ###                #
#          S  #                  #
#                    O           #
#      P                         #
#           O       X            #
#               #                #
#X            ###                #
##################################
