#####
#P  ##
#OXB #
#  # #
#    #
######