######
#P   ##
# XX  #
# #O O#
#     #
#######
