##################################
#                                #
#        X# X   #######X         #
#         #     #O               #
#         #    O#                #
#   P     #############          #
#              O#    O#          #
#               #     #          #
#         #######  X  #          #
#                                #
##################################
