##################################
#                                #
#         #     #######          #
#         #     #                #
#         #     #                #
#         #############          #
#               #     #          #
#               #     #          #
#         #######     #          #
#                                #
##################################
