######
#P   #
#  XO#
# OX #
######