######################
#          ###       #
#          #         #
#             O   O  #
#   P      X         #
#        O       X   #
#   X        #       #
#          ###       #
######################